# Map file for tile-based game
# (Lines that start with '#' are comments)
# The tiles are:
#   (Space) Empty tile
#   A..Z    Tiles A through Z
#   o       Star
#   *       Goal
                                  
BF   03     o o o                o o o o o o o o o o o o o o o o o o o o o o o                EB
AD   -     IIIIIII              IIIIIIIIIIIIIIIIIIIIIIIIIIIIIIIIIIIIIIIIIIIIIII               CA
AD                      o o o                I                   EBBBBBBBBBBBBBF     o o o o  CA
AD                     IIIIIII               I                   CAAAAAAAAAAAAAD    o o o o o CA
AD                                           I             o o   CAAAAAAAAAAAAAHF    o o o o  CA
AD                        !                               IIIII  CAAAAAAAAAAAAAAD   o o o o o CA
AD                      IIIII                                    CAAAAAAAAAAAAAAHF   IIIIIII  CA
AD         III                                                   CAAAAAAAAAAAAAAAD  o o o o o CA
AD                                   IIIIIIIIIIIII               CAAAAAAAAAAAAAAAHF  o o o o  CA
AD              EBBBBBBBBBBBBBBBF     o o o o o o           *    CAAAAAAAAAAAAAAAAD o o o o o CA
AHBBBBBBBBBBBBBBGAAAAAAAAAAAAAAAHBBBBBBBBBBBBBBBBBBB03BBBBBBBBBBBGAAAAAAAAAAAAAAAAHBBBBBBBBBBBGA