BF   01     o o o                o o o o o o o o o o o o o o o o o o o o o o o                EB
AD   -     IIIIIII              IIIIIIIIIIIIIIIIIIIIIIIIIIIIIIIIIIIIIIIIIIIIIII               CA
AD                      o o o                I                   EBBBBBBBBBBBBBF     o o o o  CA
AD}                ^^  IIIIIII               I                   CAAAAAAAAAAAAAD    o o o o o CA
AD}                vv                        I             o o   CAAAAAAAAAAAAAHF    o o o o  CA
AD                        !                               IIIII  CAAAAAAAAAAAAAAD   o o o o o CA
AD                      IIIII                                    CAAAAAAAAAAAAAAHF   IIIIIII  CA
AD         III           vvv             1    1  1               CAAAAAAAAAAAAAAAD  o o o o o CA
A02              c            c     {IIIIIIIIIIIII               CAAAAAAAAAAAAAAAHF  o o o o  CA
A               EBB^^^^^BBBBBBBBF     o o o o o o                CAAAAAAAAAAAAAAAAD o o o o o CA
AHBBBBBBBBBBBBBBGAAAAAAAAAAAAAAAHBBBBBBBBBBBBBBBBBBBBBBBBBBBBBBBBGAAAAAAAAAAAAAAAAHBBBBBBBBBBBGA