BF   01     o o o                o o o o o o o o o o o o o o o o o o o o o o o                EB
AD   -     IIIIIII              IIIIIIIIIIIIIIIIIIIIIIIIIIIIIIIIIIIIIIIIIIIIIII               CA
AD                      o o o                I                   EBBBBBBBBBBBBBF     o o o o  CA
AD                     IIIIIII               I                   CAAAAAAAAAAAAAD    o o o o o CA
AD                                           I             o o   CAAAAAAAAAAAAAHF    o o o o  CA
AD                        !                               IIIII  CAAAAAAAAAAAAAAD   o o o o o CA
AD                      IIIII                                    CAAAAAAAAAAAAAAHF   IIIIIII  CA
AD         III                          1    1  1                CAAAAAAAAAAAAAAAD  o o o o o CA
AD                                   IIIIIIIIIIIII              03AAAAAAAAAAAAAAAHF  o o o o  CA
AD              EBBBBBBBBBBBBBBBF     o o o o o o                 AAAAAAAAAAAAAAAAD o o o o o CA
AHBBBBBBBBBBBBBBGAAAAAAAAAAAAAAAHBBBBBBBBBBBBBBBBBBB01BBBBBBBBBBBGAAAAAAAAAAAAAAAAHBBBBBBBBBBBGA