# Map file for tile-based game
# (Lines that start with '#' are comments)
# The tiles are:
#   (Space) Empty tile
#   A..Z    Tiles A through Z
#   o       Star
#   !       Music Note
#   *       Goal
#   1       Bad Guy 1 (grub)
#   2       Bad Guy 2 (fly)
BF        o o o                o o o o o o o o o o o o o o o o o o o o o o o                  EB
AD   -     IIIIIII              IIIIIIIIIIIIIIIIIIIIIIIIIIIIIIIIIIIIIIIIIIIIIII               CA
AD                      o o o                I                   EBBBBBBBBBBBBBF     o o o o  CA
AD                     IIIIIII               I                   CAAAAAAAAAAAAAD    o o o o o CA
AD                     IIIIIII               I                   CAAAAAAAAAAAAAD    o o o o o CA
AD                     IIIIIII               I                   CAAAAAAAAAAAAAD    o o o o o CA
AD                     IIIIIII               I                   CAAAAAAAAAAAAAD    o o o o o CA
AD                     IIIIIII               I                   CAAAAAAAAAAAAAD    o o o o o CA
AD                     IIIIIII               I                   CAAAAAAAAAAAAAD    o o o o o CA
AD                     IIIIIII               I                   CAAAAAAAAAAAAAD    o o o o o CA
AD                     IIIIIII               I                   CAAAAAAAAAAAAAD    o o o o o CA
AD                                           I             o o   CAAAAAAAAAAAAAHF    o o o o  CA
AD                        !                               IIIII  CAAAAAAAAAAAAAAD   o o o o o CA
AD                      IIIII                                    CAAAAAAAAAAAAAAHF   IIIIIII  CA
AD         III                                                   CAAAAAAAAAAAAAAAD  o o o o o CA
AD                  b b b b b        IIIIIIIIIIIII               CAAAAAAAAAAAAAAAHF  o o o o  CA
AD b  b  b  b  b EBBBBBBBBBBBBBBF                                CAAAAAAAAAAAAAAAAD o o o o o CA
AHBBBBBBBBBBBBBBGAAAAAAAAAAAAAAAHBBBBBBB11BBBBBBBBBBBBBBBBBBBBBBBGAAAAAAAAAAAAAAAAHBBBBBBBBBBBGA