# Map file for tile-based game
# (Lines that start with '#' are comments)
# The tiles are:
#   (Space) Empty tile
#   A..Z    Tiles A through Z
#   o       Star
#   !       Music Note
#   *       Goal
#   1       Bad Guy 1 (grub)
#   2       Bad Guy 2 (fly)
BBBBBBBBBBBBBBBBBBBBBBBBBBBBBBBBBBBBBBBBBBBBBBBBBBBBBBBBBBBBBBBBBB
                                                           o     03
                                                     o      o    03
                       o o o        o o o       o     o      o   03
                      IIIIIII      IIIIIII       o     o         03
                                                  o              03
                 c                                   EF          03
                 EF                                 EGA          03
    -   EF       CD                                EGAA     *    03
BBBBBBBBGHBBBBBBBGHBEBBFBBBBBBBBB03BBBBBBBBBBBBBBBBBGAAHBBBBBBBBBBB