# Map file for tile-based game
# (Lines that start with '#' are comments)
# The tiles are:
#   (Space) Empty tile
#   A..Z    Tiles A through Z
#   o       Star
#   *       Goal
                                  
BF   03     o o o                o o o o o o o o o o o o o o o o o o o o o o o                EB
AD         IIIIIII              IIIIIIIIIIIIIIIIIIIIIIIIIIIIIIIIIIIIIIIIIIIIIII               CA
AD                      o o o                I                   EBBBBBBBBBBBBBF     o o o o  CA
ADd                ww  IIIIIII               I                   CAAAAAAAAAAAAAD    o o o o o CA
ADd                ss                        I             o o   CAAAAAAAAAAAAAHF    o o o o  CA
AD                        !                               IIIII  CAAAAAAAAAAAAAAD   o o o o o CA
AD   -                  IIIII                                    CAAAAAAAAAAAAAAHF   IIIIIII  CA
AD         III           sss                                     CAAAAAAAAAAAAAAAD  o o o o o CA
AD       x                         aIIIIIIIIIIIII                01AAAAAAAAAAAAAAHF  o o o o  CA
AD              EBBwwwwwBBBBBBBBF     o o o o o o                01AAAAAAAAAAAAAAAD o o o o o CA
AHBBBBBBBBBBBBBBGAAAAAAAAAAAAAAAHBBBBBBBBBBBBBBBBBBBBBBBBBBBBBBBBGAAAAAAAAAAAAAAAAHBBBBBBBBBBBGA