# Map file for tile-based game
# (Lines that start with '#' are comments)
# The tiles are:
#   (Space) Empty tile
#   A..Z    Tiles A through Z
#   o       Star
#   *       Goal
BF                               o o o o o o o o o o o o o o o o o o o o o o o                EB
01                              IIIIIIIIIIIIIIIIIIIIIIIIIIIIIIIIIIIIIIIIIIIIIII               CA
01                      o o o                I                   EBBBBBBBBBBBBBF     o o o o  CA
01                     IIIIIII               I                   CAAAAAAAAAAAAAD    o o o o o CA
01                                           I             o o   CAAAAAAAAAAAAAHF    o o o o  CA
01                                                        IIIII  CAAAAAAAAAAAAAAD   o o o o o CA
01                      IIIII                                    CAAAAAAAAAAAAAAHF   IIIIIII  CA
01                                                               CAAAAAAAAAAAAAAAD  o o o o o CA
01  xxx           wwwwwwwwwwww       IIIIIIIIIIIII               CAAAAAAAAAAAAAAAHF  o o o o  CA
01  x-x         EBBBBBBBBBBBBBBBF     o o o o o o        x  *    CAAAAAAAAAAAAAAAAD o o o o o CA
AHBBBBBBBBBBBBBBGAAAAAAAAAAAAAAAHBBBBBBBBBBBBBBBBBBB03BBBBBBBBBBBGAAAAAAAAAAAAAAAAHBBBBBBBBBBBGA