# map02 for CatPlanet2 (http://catplanet.resba.org/)
# 
# Map by resba (http://www.resba.org/)
#
# ==Character Definitions==
# map transitions: t,u,v,x,y,z    (map transitions and
# respawns       : f,g,h,i,j,k                         respawns are linked.)
# explicit spawns: !,@,$,%,^,&
# player spawn   : -
# tiles          : A-Z
# entities       : c (cat), b (foliage) 
# spikes         : w (facing up), s (facing down), a (facing right), d (facing left)
# everything else: (space) (air), # (comment things.)
#
:explicit=yes
:t=01
:u=03
:v=aa
:x=aa
:y=aa
:z=aa
#
BBBBBBBBBBBBBBBBBBBBBBBBBBBBBBBBBBBBBBBBBBBBBBBB
D                                              D
D                                              D
D                                              D
D                                              D
D                                              D
D                                              D
D                                              D
D                                              D
D                                              D
D                                              D
D                                              D
D                                              D
D                                              D
D                                              D
D                                              D
D                                              D
D                                              D
D                                              D
D                                              D
D                                              D
D                                              D
D                                              D
D                                              D
D                                              D
D                                              D
D                                              D
D                                              D
D                                              D
D                                              D
D                                              D
D                                              D
D                                              D
D                                              D
D                                              D
D                                              D
D                                              D
D                                              D
t                                              D
t                                              D
t  f              c                          g D
t f!f  b  b  b                              g@gu
AHBBBBBBBBBBBBBBBBBBBBBBBBBBBBBBBBBBBBBBBBBBBBBA
