# Map file f r tile-based game
# (Lines that start with '#' are c mments)
# The tiles are:
#   (Space) Empty tile
#   A..Z    Tiles A thr ugh Z
#           Star
#   *       Goal
F                    x02
D                    x02
D          x         x02
D    c               x02
D   BBB              x02
D                    x02
D                    x02
D                c   x02
D              BBB   x02
Dd                   x02
D                    x02
D                    x02
D                    x02
D            c       x02
D          BBB       x02
D xxx                x02
D x-x b cb  b  b     x02
AHBBBBBBBBBBBBBBAAAAAAAA