# Map file f r tile-based game
# (Lines that start with '#' are c mments)
# The tiles are:
#   (Space) Empty tile
#   A..Z    Tiles A thr ugh Z
#           Star
#   *       Goal
F                      D
D                      B
D                      B
D    c                 B
D   BBB                B
D                      B
D                      B
D                 c    B
D               BBB    B
D                      B
D                      B
D                      B
D                      B
D            c         B
D          BBB         B
D                      B
D  -  b cb  b  b       E
AHBBBBBBBBBBBBBBAAAAAAAA