# Map file f r tile-based game
# (Lines that start with '#' are c mments)
# The tiles are:
#   (Space) Empty tile
#   A..Z    Tiles A thr ugh Z
#           Star
#   !       Music N te
#   *       Goal
BF                                                                                            EB
AD   -     BBBBBBB              BBBBBBBBBBBBBBBBBBBBBBBBBBBBBBBBBBBBBBBBBBBBBBB               CA
AD                                           B                   EBBBBBBBBBBBBBF              CA
AD                     BBBBBBB               B                   CAAAAAAAAAAAAAD              CA
AD                     BBBBBBB               B                   CAAAAAAAAAAAAAD              CA
AD                     BBBBBBB               B                   CAAAAAAAAAAAAAD              CA
AD                     BBBBBBB               B                   CAAAAAAAAAAAAAD              CA
AD                     BBBBBBB               B                   CAAAAAAAAAAAAAD              CA
AD                     BBBBBBB               B                   CAAAAAAAAAAAAAD              CA
AD                     BBBBBBB               B                   CAAAAAAAAAAAAAD              CA
AD                     BBBBBBB               B                   CAAAAAAAAAAAAAD              CA
AD                                           B                   CAAAAAAAAAAAAAHF             CA
AD                                                        BBBBB  CAAAAAAAAAAAAAAD             CA
AD                      BBBBB                                    CAAAAAAAAAAAAAAHF   BBBBBBB  CA
AD         BBB                                                   CAAAAAAAAAAAAAAAD            CA
AD                  b b b b b        BBBBBBBBBBBBB               CAAAAAAAAAAAAAAAHF           CA
AD b  b cb  b  b EBBBBBBBBBBBBBBF                                CAAAAAAAAAAAAAAAAD           CA
AHBBBBBBBBBBBBBBGAAAAAAAAAAAAAAAHBBBBBBB11BBBBBBBBBBBBBBBBBBBBBBBGAAAAAAAAAAAAAAAAHBBBBBBBBBBBGA