# Map file for tile-based game
# (Lines that start with '#' are comments)
# The tiles are:
#   (Space) Empty tile
#   A..Z    Tiles A through Z
#   o       Star
#   *       Goal
                                  
BF   03                          o o o o o o o o o o o o o o o o o o o o o o o                EB
AD                              IIIIIIIIIIIIIIIIIIIIIIIIIIIIIIIIIIIIIIIIIIIIIII               CA
AD                                           I                   EBBBBBBBBBBBBBF     o o o o  CA
ADd                                          I                   CAAAAAAAAAAAAAD    o o o o o CA
ADd                                          I                   CAAAAAAAAAAAAAD    o o o o o CA
ADd                                          I                   CAAAAAAAAAAAAAD    o o o o o CA
ADd                                          I                   CAAAAAAAAAAAAAD    o o o o o CA
ADd                                          I                   CAAAAAAAAAAAAAD    o o o o o CA
ADd                                          I                   CAAAAAAAAAAAAAD    o o o o o CA
ADd                                          I                   CAAAAAAAAAAAAAD    o o o o o CA
ADd                ww                        I                   CAAAAAAAAAAAAAD    o o o o o CA
ADd                ss                        I             o o   CAAAAAAAAAAAAAHF    o o o o  CA
AD                                                        IIIII  CAAAAAAAAAAAAAAD   o o o o o CA
AD   -                                                           CAAAAAAAAAAAAAAHF   IIIIIII  CA
AD                       sss                                     CAAAAAAAAAAAAAAAD  o o o o o CA
AD              c            c     aIIIIIIIIIIIII                CAAAAAAAAAAAAAAAHF  o o o o  CA
AD              EBBwwwwwBBBBBBBBF     o o o o o o                CAAAAAAAAAAAAAAAAD o o o o o CA
AHBBBBBBBBBBBBBBGAAAAAAAAAAAAAAAHBBBBBBBBBBBBBBBBBBBBBBBBBBBBBBBBGAAAAAAAAAAAAAAAAHBBBBBBBBBBBGA